Level 11-7
Password: 7V5V
Time: 2'30"

- - - - - - - - - -
-     E   B       -
- G   G   G P     -
- - - -   - - - - -
-                 -
-       ~         -
- - - -   - -     -
      -   - -     -
      - P - -     -
      - B - -     -
      - E - -     -
      - - - - - - -
