Level 14-9
Password: B35C
Time: 3'00"

- - - - - - - -
- - -   - - - -
- B - E - B - -
- G - G - G - -
- B   E   E - -
- - - -   - - -
- -     G     -
- -     -   G -
- - -       - -
- - - -   - - -
- - - -   - - -
- - - - - - - -
