Level 2-4
Password: VTT5
Time: 1'00"

- - - - - - - - -
-       B       -
-   B   E   B   -
-   P   G   E   -
-   - - | - -   -
-               -
-   - - G   -   -
-   -   -   -   -
-   -       -   -
-   -   - P -   -
-   - - - - -   -
- - - - - - - - -
