- - - - - - - - - -
- E   X     E X E -
- C T G     D P B -
- - E -     - E - -
- - - -     - - - -
- -             - -
- -             - -
- -   D C X P   - -
- -   T - - B   - -
- -   X - - G   - -
- -   D     E   - -
- - - - - - - - - -