Level 4-7
Password: 37CL
Time: 1'30"

- - - - - - - - - -
-                 -
- X -         - E -
- P - C     C - G -
- B - -   C - - B -
- G E     -   X P -
- - -         - - -
-                 -
- ~               -
-   -   -   -   - -
-   -   -   -   - -
- - - - - - - - - -
