Level 5-9
Password: JJV7
Time: 2'00"

- - - - - - - - - -
-   P             -
-   - - - - - -   -
-             -   -
- - - - - -   -   -
-           X -   -
-   - - - - - G   -
- P           -   -
- - - - - -   - B -
- B G       X - E -
- E - -   - - - | -
- - - - - - - - - -
