Level 7-6
Password: CRP5
Time: 2'00"

- - - - - - - - - -
- E   - - - -     -
- B   - - - -     -
- X     - - -     -
- P   C   - -     -
- E   G     -     -
- B   - C         -
- X   - - P       -
- E   - - -       -
- B   - - - -     -
- G | - - - -     -
- - - - - - - - - -
