Level 8-6
Password: C1FW
Time: 2'00"

  - - - - - - -
-               -
- E   G       E -
- - B -   B - G -
- - - -   -   - -
- -   -   -   - -
-     G   G     -
-     -   -     -
-     -   -     -
-     -   -     -
-       |       -
- - - - - - - - -
