- - - - - - - - - -
-                 -
-                 -
-   - - - - - -   -
-       E -       -
-   C E - - P     -
-   X P -   E B   -
-   - - - - - -   -
-     C - G       -
-   G X - - B G   -
- | - - - - - -   -
- - - - - - - - - -