Level 9-6
Password: R5RC
Time: 3'00"

                - -
  - - - - - - -   -
  -     - - - -   -
  -       - - -   -
- E   X P B G E   -
- - - - - - - -   -
- - E   X P B G   -
- - - - - - - -   -
- ~               -
  - - - - - - -   -
            - -   -
            - - - -
            